[17 12]
XXXXXXXXXXXXXXXXX
XHR            DX
X...    ...   ..X
X...    ...   ..X
X..R    R R   R.X
X..R    .M.   R.X
X..R    . .   R.X
X..R    . .   R.X
X..R    . .   R.X
X..R    . .   R.X
X..R    .A.   R.O
XXXXXXXXXXXXXXXXX

