[25 12]
XXXXXXXXXXXXXXXXXXXXXXXXX
XHR                    DX
X...    ...           ..X
X...    ...           ..X
X..R    R.R           R.X
X..R   R.M.R          R.X
X..R  ... ...         R.X
X..R    . .           R.X
X..R    . .    xxxxxx R.X
X..R    . .    x    x R.X
X..R    .A.    x A  x R.O
XXXXXXXXXXXXXXXXXXXXXXXXX
